################################
#..............................#
#..............................#
#..............................#
#..............................#
#..............................#
#..............................#
#...........#########..........#
#...........#########..........#
#..............##..............#
#..............##..............#
#..............##..............#
#..............##..............#
#..............##..............#
#..............##..............#
##############....##############
##############....##############
#..............##..............#
#..............##..............#
#..............##..............#
#..............##..............#
#..............##..............#
#..............##..............#
#..............##..............#
#.............####.............#
#.............####.............#
#..............##..............#
#..............##..............#
#..............##..............#
#..............##..............#
#..............................#
################################