################################
#..............................#
#..............................#
#..............................#
#..............................#
#..............................#
#..............................#
#......##..............##......#
#......##..............##......#
#..............................#
#..............................#
#..............................#
#..............................#
#..............................#
#..............................#
##############....##############
##############....##############
#..............................#
#..............................#
#..............................#
#..............................#
#..............................#
#..............................#
#..............................#
#.............####.............#
#.............####.............#
#..............................#
#..............................#
#..............................#
#..............................#
#..............................#
################################