################################
#......................#.......#
#...........##.................#
#..............................#
#...............###............#
#..............................#
#........#.....................#
#..............###.............#
#..............###.............#
#..............................#
#........#...............#.....#
#..............................#
#..............................#
#........#.....................#
##############....##############
##############....##############
#..............................#
#..............................#
#..............................#
#........#.....................#
#..............###.............#
#..............###.............#
#..............................#
#........#...............#.....#
#..............................#
#..............................#
#...............###............#
#..............................#
#...........##.................#
#......................#.......#
#..............................#
################################