################################
#####......#####..####.....#####
###.........##.......##.......##
##..............##............##
#..............#####...........#
#..............................#
#........#.............##......#
#..............###.............#
#..............#####...........#
#...............####...........#
#........#...............#.....#
#..............................#
#####..........................#
#########.................######
##############....##############
##############....##############
########................########
#####......................#####
#..............................#
#........#.....................#
#..............###.............#
#...........########...........#
#...............#####..........#
#........#...............#.....#
#..............................#
#..............................#
#...............###............#
#...........######.............#
#...........##.............#####
#......................#########
#........................#######
################################