######.....R..##################
######....######################
######.S....####################
####################....########
###################R......######
######...###########..S..#######
###......R######################
#####..S.############.....######
#####################....#######
####################.R.S..######
######...R.#####################
#####....#######################
#####.S.###########......#######
################.........R..####
###################......#######
####################..S..#######
######.......###################
#####........R..################
######.......###################
#######..S..#######.......######
##################R.........####
###################....S..######
################################
################################