################################
#####.............####.....#####
###.........##.......##.......##
##.............................#
#...............###............#
#..............................#
#........#.....................#
#..............###.............#
#..............#####...........#
#...............####...........#
#........#...............#.....#
#..............................#
#####..........................#
#########.................######
##############....##############
##############....##############
########................########
#####......................#####
#..............................#
#........#.....................#
#..............###.............#
#...........########...........#
#...............#####..........#
#........#...............#.....#
#..............................#
#..............................#
#...............###............#
#...........######.............#
#...........##.............#####
#......................#########
#........................#######
################################